NO images/matrix.xpm
SO images/matrix.xpm
WE images/matrix.xpm
EA images/matrix.xpm

F 0,0,0
C 0,0,0






        1111111111111111111111111
        1                  101  1
        1111111111111111111111111
        1N00000000110000000000001
        111111111111111111111111111111
        10000100011111     100000000001111
        10110000011111  1  110000000001111
        10110000011111     110000000001111
        100100000011101111100000111111
11111111101100001110000000000001
100000000011000000010111111111111
11110111111111011100000010001
11111111111111010001010010001
11010100110101011100000010001
10000000000000001100000100111
10000000000000001101010010001
1100000111010101111101111000111111
11110111 1110101 101111010001
11111111 1111111 11111110111
  1111     1111      1111
